1 4 2405 2126 1218 4997
1 4 4558 4851 2939 4018
1 7 4018 6687 6665 6643 4122 2176 6567
1 3 6567 2176 3779
1 3 4018 29 6638
1 5 6638 6632 4535 2031 4141
1 7 4535 6661 4834 2727 6713 6732 6745
1 9 6745 6732 6713 6711 3706 1324 1670 1319 6642
1 4 1324 301 2119 402
1 3 2119 6532 6490
1 5 6745 6761 4811 2999 6807
1 4 4895 46 6197 6216
1 4 4895 46 6197 3724
1 5 4895 6199 2294 6162 4443
1 7 4895 6229 323 4854 3120 6270 6286
1 4 5605 1647 5520 3677
1 3 28 1386 4636
1 4 4996 6512 3672 6482
1 6 672 6425 102 2713 854 28
1 7 2390 2926 3430 3069 4218 6439 672
1 4 6482 6472 970 6439
1 2 6490 2713
1 6 28 1702 2997 2832 302 6658
1 4 2832 260 279 1749
1 4 28 501 6453 182
1 6 12038 3397 4151 1644 2749 1805
1 6 3397 1868 2140 530 1028 5720
1 8 2140 371 3589 1751 3801 3251 1636 2393 
1 7 3397 5902 5938 4914 6001 1082 1798
1 5 1798 4133 2385 6094 6131 
1 8 5902 1879 4499 6012 6041 4840 4012 1820
1 4 6146 1809 6184 1725
1 8 1798 3725 591 4491 2704 6168 4586 6203
1 7 3218 1751 3620 1805 5956 5986 1798
1 5 3251 5968 4395 4103 6043
1 11 182 3640 13 2817 3378 6491 1963 213 1716 1070 3563
1 8 6658 96 6666 536 560 1802 3050 1070
1 4 96 1935 6788 933
1 5 1070 3184 59 6527 109
1 9 3378 1810 6421 97 1500 2860 2899 373 6363 
1 5 109 6464 848 4952 2899
1 5 6363 1223 2226 6282 2198
1 6 109 985 4065 80 881 2946
1 6 2946 3685 1795 6727 4945 6782
1 5 6789 4975 2980 6828 3546
1 6 1795 2057 3395 4510 1288 4081
1 7 1795 1210 6623 2034 278 6480 2300
1 7 2300 3450 795 4897 2666 6443 2808
1 4 2666 6401 1960 1120
1 3 4065 6503 1111
1 5 97 2620 1031 3935 109
1 4 1031 3482 894 1716
1 6 2860 3506 3077 6315 3041 6323
1 13 97 2085 2012 6362 706 6369 220 6374 6355 875 511 237 854
1 5 237 2135 413 2514 672
1 6 6355 1855 6298 3829 1149 3258
1 9 2514 6383 333 6353 1429 4699 62 1091 2593
1 6 2593 3129 831 2501 6357 2390
1 10 819 6237 3238 6268 3199 6292 2458 4924 3731 2388
1 4 2628 1867 115 173
1 4 115 1714 6188 4457
1 2 1867 1714
1 9 6188 2682 1767 3384 6129 3867 3956 728 235
1 4 870 997 3490 4527
1 8 3956 870 6106 2200 3308 4327 6002 366
1 8 5975 5998 1901 886 4485 1346 6047 2628
1 6 2628 565 5873 241 3941 5728
1 13 6002 4753 1457 5930 3415 5862 1365 4330 381 3269 2644 2016 5665
1 3 5728 5716 2016
1 7 3269 5722 4547 1201 1010 3140 5561
1 9 2226 6301 1180 1996 6259 2908 3134 6204 728
1 6 3134 2984 1680 4436 1933 3041
1 9 2628 2161 6055 3572 6035 4131 6063 2366 3258
1 11 2366 2262 6053 370 3558 4382 1663 6050 6085 2675 988
1 5 988 1214 1234 1784 2593
1 4 1234 3630 6241 6237
