1 4 2405 2126 1218 4997
1 4 4558 4851 2939 4018
1 7 4018 6687 6665 6643 4122 2176 6567
1 3 6567 2176 3779
1 3 4018 29 6638
1 5 6638 6632 4535 2031 4141
1 7 4535 6661 4834 2727 6713 6732 6745
1 9 6745 6732 6713 6711 3706 1324 1670 1319 6642
1 4 1324 301 2119 402
1 3 2119 6532 6490
1 5 6745 6761 4811 2999 6807
1 4 4895 46 6197 6216
1 4 4895 46 6197 3724
1 5 4895 6199 2294 6162 4443
1 7 4895 6229 323 4854 3120 6270 6286
1 4 5605 1647 5520 3677
1 3 28 1386 4636
1 4 4996 6512 3672 6482
1 6 672 6425 102 2713 854 28
1 7 2390 2926 3430 3069 4218 6439 672
1 4 6482 6472 970 6439
1 2 6490 2713
1 6 28 1702 2997 2832 302 6658
1 4 2832 260 279 1749
1 4 28 501 6453 182
1 6 12140 3397 4151 1644 2749 1805
1 6 3397 1868 2140 530 1028 5720
1 8 2140 371 3589 1751 3801 3251 1636 2393 
1 7 3397 5902 5938 4914 6001 1082 1798
1 5 1798 4133 2385 6094 6131 
1 8 5902 1879 4499 6012 6041 4840 4012 1820
1 4 6146 1809 6184 1725
1 8 1798 3725 591 4491 2704 6168 4586 6203
1 7 3218 1751 3620 1805 5956 5986 1798
1 5 3251 5968 4395 4103 6043
