1 5 5460 2405 2126 1218 4997 
1 4 4558 4851 2939 4018 
1 7 4018 6687 6665 6643 4122 2176 6567 
1 3 6567 2176 3779 
1 3 4018 29 6638 
1 5 6638 6632 4535 2031 4141 
1 7 4535 6661 4834 2727 6713 6732 6745 
1 9 6745 6732 6713 6711 3706 1324 1670 1319 6642 
1 4 1324 301 2119 402 
1 3 2119 6532 6490 
1 5 6745 6761 4811 2999 6807 
1 4 4895 46 6197 6216 
1 4 4895 46 6197 3724 
1 5 4895 6199 2294 6162 4443 
1 7 4895 6229 323 4854 3120 6270 6286 
1 4 5605 1647 5520 3677 
1 3 28 1386 4636 
1 4 4996 6512 3672 6482 
1 6 672 6425 102 2713 854 28 
1 7 2390 2926 3430 3069 4218 6439 672 
1 4 6482 6472 970 6439 
1 2 6490 2713 
1 6 28 1702 2997 2832 302 6658 
1 4 2832 260 279 1749 
1 4 28 501 6453 182 
1 6 12038 3397 4151 1644 2749 1805 
1 6 3397 1868 2140 530 1028 5720 
1 8 2140 371 3589 1751 3801 3251 1636 2393 
1 7 3397 5902 5938 4914 6001 1082 1798 
1 5 1798 4133 2385 6094 6131 
1 8 5902 1879 4499 6012 6041 4840 4012 1820 
1 4 6146 1809 6184 1725 
1 8 1798 3725 591 4491 2704 6168 4586 6203 
1 7 3218 1751 3620 1805 5956 5986 1798 
1 5 3251 5968 4395 4103 6043 
1 10 182 3640 13 2817 3378 6491 1963 213 1716 1070 
1 8 6658 96 6666 536 560 1802 3050 1070 
1 4 96 1935 6788 933 
1 5 1070 3184 59 6527 109 
1 9 3378 1810 6421 97 1500 2860 2899 373 6363 
1 5 109 6464 848 4952 2899 
1 5 6363 1223 2226 6282 2198 
1 6 109 985 4065 80 881 2946 
1 6 2946 3685 1795 6727 4945 6782 
1 5 6789 4975 2980 6828 3546 
1 6 1795 2057 3395 4510 1288 4081 
1 7 1795 1210 6623 2034 278 6480 2300 
1 7 2300 3450 795 4897 2666 6443 2808 
1 4 2666 6401 1960 1120 
1 3 4065 6503 1111 
1 5 97 2620 1031 3935 109 
1 4 1031 3482 894 1716 
1 6 2860 3506 3077 6315 3041 6323 
1 13 97 2085 2012 6362 706 6369 220 6374 6355 875 511 237 854 
1 5 237 2135 413 2514 672 
1 6 6355 1855 6298 3829 1149 3258 
1 9 2514 6383 333 6353 1429 4699 62 1091 2593 
1 6 2593 3129 831 2501 6357 2390 
1 10 819 6237 3238 6268 3199 6292 2458 4924 3731 2388 
1 4 2628 1867 115 173 
1 4 115 1714 6188 4457 
1 2 1867 1714 
1 9 6188 2682 1767 3384 6129 3867 3956 728 235 
1 4 870 997 3490 4527 
1 8 3956 870 6106 2200 3308 4327 6002 366 
1 8 5975 5998 1901 886 4485 1346 6047 2628 
1 6 2628 565 5873 241 3941 5728 
1 13 6002 4753 1457 5930 3415 5862 1365 4330 381 3269 2644 2016 5665 
1 3 5728 5716 2016 
1 7 3269 5722 4547 1201 1010 3140 5561 
1 9 2226 6301 1180 1996 6259 2908 3134 6204 728 
1 6 3134 2984 1680 4436 1933 3041 
1 9 2628 2161 6055 3572 6035 4131 6063 2366 3258 
1 11 2366 2262 6053 370 3558 4382 1663 6050 6085 2675 988 
1 5 988 1214 1234 1784 2593 
1 4 1234 3630 6241 6237 
1 11 12037 3702 1279 5733 195 4304 4128 2605 967 2451 5661 
1 8 5733 5688 1140 714 3293 5506 268 1706 
1 13 4128 2800 428 5606 5579 3418 535 4033 3861 1896 5580 4264 5628 
1 8 1994 4727 1511 5736 4717 3171 5701 967 
1 7 1070 3563 668 6696 3240 2129 1985 
1 5 1985 4387 3390 3976 404 
1 5 4859 782 3917 6956 2147 
1 6 4479 1836 1743 6872 6894 6927 
1 5 6926 649 4908 6986 7003 
1 9 4908 4114 118 1966 3445 6878 1537 1482 6807 
1 7 1482 6821 6816 4664 4269 3214 1749 
1 5 118 4003 6965 3212 6955 
1 7 7003 3475 3309 7039 3788 1727 7067 
1 9 1727 3513 1157 623 656 2352 1335 6841 933 
1 5 6926 3869 2325 4968 2352 
1 4 4968 1336 120 279 
1 8 6841 778 4579 3721 7042 3859 2 64 
1 9 64 7089 7076 3146 3226 4662 1590 7000 4193 
1 6 7057 189 7004 3721 809 4570 
1 5 4193 1704 4539 4108 909 
1 7 4744 909 4618 1176 2346 3886 104 
1 4 536 326 2258 104 
1 7 536 1132 2240 4034 732 438 4743 
1 6 104 6759 6739 852 6712 668 
1 7 1176 2026 6892 3880 1503 605 964 
1 7 3880 6909 6923 6910 1406 4640 1762 
1 3 852 6768 1860 
1 2 64 4922 
1 6 1575 4510 6635 2472 407 278 
1 8 4081 1413 936 2472 6553 3222 3602 1103 
1 9 1103 464 5027 297 3434 6387 976 6375 3392 
1 4 12039 3186 101 12040 
1 41 5490 5507 5510 4013 5530 5543 4242 3596 3358 5571 2437 770 601 690 2528 1352 545 4962 3044 5309 100 4785 556 5351 21 4919 2942 845 812 5324 2894 488 5346 1660 5377 3075 836 3479 2343 2349 4300 
1 10 4300 3261 5598 5 4695 4818 5492 5471 5427 457 
1 9 4818 5535 638 5525 431 4493 76 2925 1911 
1 8 566 2005 5608 4360 1249 5679 2737 144 
1 6 4288 5381 3091 1334 2508 545 
2 15 5318 4963 5329 5322 2686 4937 4288 2120 4697 4031 5418 5403 3628 5374 2830 
1 3 1111 977 1456 
1 2 6286 419
1 3 419 4160 6337
1 4 6337 168 6332 2158
1 3 2158 3010 6310
1 4 6310 2263 6290 1940
1 4 6263 6277 6290 1940
1 4 6263 1090 6229 4895
1 5 1940 2077 801 3246 6216
1 4 3724 3656 5001 897
1 6 3588 2395 692 3772 6199 4895
1 7 3667 6072 4904 2416 6066 3840 2382
1 9 2382 4861 3292 3557 6036 6015 6033 3595 2892
1 4 2892 1183 6089 356
1 9 2892 3597 6025 4462 6014 3402 3958 2409 5993
1 7 5993 5948 3125 3177 5907 4435 5857
1 7 5993 3459 3168 3512 4972 3780 1674
1 10 5857 1521 5821 2269 1825 5745 1059 2159 513 5605
1 8 5605 472 1203 4503 5463 5436 5412 1899
1 5 1899 4983 3496 2769 4955
1 6 4955 5339 5349 5357 5368 5379
1 7 4867 5484 1466 1320 1203 472 5605
1 6 4867 4644 798 339 1737 5384
1 7 5384 2562 5449 5501 1341 2491 696
1 9 2382 261 4072 3696 3447 4634 2128 5738 2858
1 3 3667 3409 2294
1 6 6240 681 3056 6294 6308 3455
1 4 6240 4308 890 455
1 4 444 5413 3423 2347
1 4 3167 2105 5431 444
1 5 5605 3762 906 188 5805
1 5 4867 265 2028 865 483
1 8 356 6161 1890 3001 6155 4929 3247 6160
1 7 5993 5966 2634 2266 485 5880 5846
1 6 5605 772 4019 996 4495 5527
1 6 3677 5452 2179 5441 5443 2291
1 7 5605 5682 3255 4289 523 5909 2038
1 10 377 5263 979 2197 3 2814 299 1796 5444 696
1 9 377 4626 3887 674 126 3605 3138 5200 432
1 6 432 1192 5190 2336 1817 4742
1 10 31 1736 4061 1701 149 5227 4064 2298 132 432
1 8 31 130 4260 2039 2132 587 4107 611
1 14 4064 5231 70 3872 2030 1583 5303 4769 2652 1105 3097 5516 293 2003
1 5 3 575 1109 579 293
1 16 286 5047 4674 3325 1029 5095 4793 3025 965 773 1307 5238 250 1912 3718 377
1 33 4674 5054 5057 3329 5063 5062 5068 2626 5081 5086 3346 2470 5093 5089 2670 3034 3846 2963 5105 2610 5112 5097 5090 5088 3934 3758 5116 5136 2356 4296 5177 5188 432
1 16 611 131 5524 1936 5558 2745 4825 5603 1659 5642 5626 340 3254 5624 5623 3375
1 13 611 2985 2913 3925 715 726 255 4633 2344 2608 2507 201 2301
1 8 286 3948 3242 1956 5061 5071 5075 4560
1 10 286 5042 2796 4287 5045 5041 5036 1616 4178 3916
1 11 1904 4933 5154 5142 5124 4044 2627 3379 5073 3654 4207
1 11 5175 5182 519 3393 1101 5150 5147 1599 5148 2739 4111
1 9 5175 3298 5146 2617 5109 4771 5070 5058 5052
1 5 5175 4412 5161 1158 2918
1 6 2918 3410 2316 5178 1116 2339
1 7 5175 2636 2233 4004 1769 731 4767
1 18 4111 5135 4502 2967 2342 5187 389 3189 3575 5233 4142 4800 5245 5252 5264 2246 453 4767
1 7 267 851 3224 208 3446 6345 624
5 19 12045 12046 12051 12047 12048 12049 12043 12050 12052 12046 391 12053 1611 12054 839 12056 134 12055 391
5 3 12045 12050 134
5 3 12045 12049 839
5 3 12045 12047 1611
5 3 12045 12043 12056
5 3 12045 12052 12055
5 3 12045 12051 12053
5 3 12045 12048 12054
2 5 12952 12097 12836 13479 12799
2 3 12799 12134 12113
2 6 12113 13223 12999 12198 13286 12686
1 3 12999 12494 13012
2 4 12799 13388 12302 12392
1 2 12392 12957
2 7 12392 13331 13273 12195 12794 12133 13366
1 2 12794 12096
1 5 13366 12393 12100 13447 12913
1 6 12957 12983 12676 12622 12178 12536
1 3 12536 13084 12515
2 5 12952 13489 12416 13490 12640
2 6 12640 13483 12897 13041 13143 12599
1 4 12599 12692 12111 14237
1 4 14237 14238 14239 12786
2 5 12640 12444 12906 12260 13467
2 4 13467 12214 12881 12173
2 5 12173 12095 12732 12597 13279
1 4 13467 12610 13247 13460
1 6 12392 12570 12362 13257 12173
1 1 3 12786 13404 12218